################################
#.........##x##................#
###............................#
#  .....................##.....#
####....................##.....#
#  #....#######.........##.....#
#..#....#######.........##.....#
#............@..........##.....#
#...........##############.....#
#...........##############.....#
#...........##   ..............x
#...........##   ..............#
#...........##.......##........#
#...........##.......##........#
x...........##.......###########
#...........####.....##........#
#...........####.....##........#
#..............................#
#..............................#
###################............#
#............    ##............#
#............    ##............#
#................##............#
#...###..........##......###...#
#...###..........##......###...#
#...###..........##......###...#
#.........#########............#
#.........#########............#
#..............##..............#
#..............##..............#
#.....................#####....#
##############x#################
