################################
#.........##x##................#
#......................###.....#
#......................###.....#
#......................###.....#
#     #............#######.....#
#     #............#######.....#
#     #............##..........#
#######............##..........#
#..................##..........#
#..................##..........#
#..................##..........#
#..................##..........#
#....   ...........##..........#
#.............@................#
#..............................#
x..............................#
#..............................#
######.........................#
#..............................#
#..............................#
#....###...............###.....#
#....###...............###.....#
#....###...............###.....#
#..............................#
#..............................#
#..............................#
#..............................#
#..............................#
#..............................#
#.....................#####....#
##############x#################
