################################
#.........##x##................#
#...####..............   ......#
#...####..............   ......#
#..............................#
#.....#####################....#
#.....#####################....#
#.....##.................##....#
#.....##.................##....#
#.....##...############..##....#
#.....##...##...     ##..##....#
#.....##...##...     ##..##....#
########...##....######..##....#
#..........##....@...##..##....#
x..........##............##....#
#..........##............##....#
#############.....#########....#
#.................#########....#
#.................#............#
#...###############............#
#...##...........##............#
#...##...######..##########....#
#...##.......##..##########....#
#...######...##..##   .........#
#...##.......##..##   .........#
#...##...######..##   .........#
#...##.......##..########......#
#...##.......##..########......#
#...######...##................#
#............##................#
#............##................#
################################
