################################
#..............................#
#...####..............   ##....#
#...####..............   ##....#
#.....................#####....#
#.....#####.###############....#
#.....#...................#....#
#.....#........@........###....#
#.....#...................#....#
#.....###.................#....#
#.......#...#...   .......#....#
#.......#...#...   .......#....#
#########...#.............#....#
#...........#..................#
x...........#..................x
#...........#..................#
#############.....#########....#
#############.....#########....#
#.................##...........#
##..######    ....##...........#
#.................##...........#
#.................##.....##....#
#.....##..........##.....##....#
#.....##.......................#
#..............................#
#..............................#
#.........#########............#
#.........#########............#
#.............##...............#
#.............##...............#
#.....................#####....#
##############x#################
