################################
#....##...   ##Q##   ....##....#
#......#................#......#
#########..............#########
#......#................#......#
#....##..................##....#
#..  ......................  ..#
#..  ......................  ..#
#..............................#
#..............................#
#..............................#
x..............................x
#..............................#
#..............................#
#..............................#
#.............@................#
#..............................#
#..............................#
#..............................#
#..............................#
#..............#...............#
#..##.........###........##....#
#..##........#.#.#.......##....#
#...........#..#..#............#
#..............#...............#
#..............#...............#
#..............#...............#
#.............###..............#
#..............................#
#..............................#
#...#####.............#####....#
##############x#################
