################################
#  .......#####..........#######
###...........................K#
#........................#######
###......................#######
#..............................#
#..............................#
#............@.................#
#..............................#
#..............................#
#..............................x
#....   .......................#
#....   .......................#
#....   .......................#
#..............................#
#..............................#
#.............#############....#
#.............#############....#
#........................##....#
#########................##....#
#........................##....#
#........................##....#
#.....##..........#########....#
#.....##..........#########....#
#.................##...........#
#.................##...........#
#.................##...........#
#..............................#
#..............................#
#..............................#
#.....................#####....#
##############x#################
