################################
#.........##x##................#
#...#####......................#
#.....#........................#
#.....#........................#
#.....#........................#
#.....#........................#
#............@.........####....#
#...#####..............#.......#
#...#   #..............#..##...#
#...#   #..............#...#...x
#...#   #..............#####...#
#...#####......................#
#.......................###....#
#...#####..............#   #...#
#...#   #..............#####...#
#...#####..............#...#...#
#...#..................#...#...#
#...#..........................#
#......................##.##...#
#......................#.#.#...#
#......................#...#...#
#......................#...#...#
#......................#...#...#
#..............................#
#......................#####...#
#......................#.......#
#......................####....#
#......................#.......#
#......................#####...#
#..............................#
##############x#################
