################################
#.........##x##................#
###............................#
#..............................#
###............................#
#..............................#
#..............................#
#............@.................#
#....................###########
#....................##........#
#....................##........x
#....   .............##........#
#....   .............##........#
#....   .........######........#
#................######........#
#..............................#
#..............................#
#..............................#
#..............................#
#########......................#
#..............................#
#........................##....#
##########.....................#
##########.....................#
#K......##.....................#
######..##.....................#
######..##.....................#
#.......######.................#
#.......######.................#
#..............................#
#.....................#####....#
################################
