################################
#.........##x##................#
###............................#
#..............................#
###............................#
#..............................#
#..............................#
#............@.................#
#.......................########
#.......................#......#
#.......................#......x
#............####.......#......#
#............#..#.......#......#
#....   .....#..#.......#......#
#............#..#.......#......#
#............#..#########......#
x..............................#
#..............................#
#..............................#
#########......................#
#..............................#
#........................##....#
#.....##.......................#
#.....##.......................#
#..............................#
#..............................#
#..............................#
#..............................#
#..............................#
#..............................#
#.....................#####....#
################################
