################################
#.........##.##................#
###............................#
#..............................#
###............................#
#..............................#
#..............................#
#............@.................#
#..............................#
#..............................#
#..............................#
#..............................#
#........................#######
#....   ............############
#...................############
#..............................#
x..............................#
#........................##....#
#........................##....#
########..............   ##....#
#K....##............#######....#
####..##............#######....#
#.....##............##.........#
#.....##............##.........#
#.....##............##.........#
#.....################.........#
#.....################.........#
#..............................#
#..............................#
#..............................#
#.    ................#####....#
##############x#################
